################################
#0..............#.............*#
#..#...######...#...######..#..#
#..#.....#......#......#....#..#
#..#.....#......#......#....#..#
#..###...#..#########..#..###..#
#..#........................#..#
#..#........................#..#
#..#..####..########..####..#..#
#........#..########..#........#
#........#..########..#........#
#..###...#............#...###..#
#..###...#............#...###..#
#..............................#
#..............................#
#...........###...###..........#
#...........#.......#..........#
#...######..#########..######..#
#.....#...................#....#
#.....#..####...#...####..#....#
#.....#..#......#......#..#....#
#.....#..#......#......#..#....#
#.....#..#..#########..#..#....#
#..............................#
#..............................#
#..####..#..#########..#.####..#
#..#.....#.............#....#..#
#..#.....#.............#....#..#
#..#...#######.....#######..#..#
#......#######.....#######.....#
#*............................*#
################################
